1111111111111111
1000000000001001
1000000000001001
1000000000111001
1000000000000001
1000001100000001
1000000000000001
1000000000000001
1000000001111001
1100000000000001
1100000000000001
1111111111111111